0000000000000000000000000000000000000000
0111110000011111110000000000011111011111
0100010000010000010000000000010001000101
0111010001110000010000000111110001110101
0101010001000000010000000100000000010101
0101011111000000010000000111110000010101
0101000000000000010000000000010000010101
0101000000000001110000000001110000010101
0101000000000001000000000001000000010101
0101000000000001000111110111000001110001
0001000000000001000100010100000001000001
0111000000000001011100010111000001111101
0100000000000001010000010001000000000101
0111000000000001110000011101111101110111
0001000000000000000000000101000100010001
0101000000011100011100000101110111011101
0101000000010100010100000100010001010001
0101111111010111110100000101011101011101
0100000001010000000100000101000101000101
0111011111010111011100011101111101110111
0100010000010001010000010000000001010000
0111011111110111011111011111111101011111
0101000000000100000000000000000100000001
0101111101111101111111110111110111111111
0100010101000101010000010001010000000001
0101110101010101011111011111011101110111
0001000001010101000001000000000101010100
0111011111010111011101111111110111010111
0100010000010000010100000000010000010001
0111110111111111110111111101110111111101
0100000000010000000000000101000000000001
0101111111011111110111011101111111111111
0100010001000000010100010000000000000000
0111110111011101110111011101111101111111
0000000100010101000001000100010101000001
0111110101110101111101111101110101011111
0101000101000100000100010001000101010000
0101111101010101110111010111010101011101
0100000001010101010001010100010101000101
0111111111011111011111011101111111011110